Mỗi	M
buổi	N
sáng	N
,	CH
Lan	Np
thức	V
dậy	V
sớm	A
để	E
đi	V
học	V
.	CH

Con	Np
chim	N
chích_bông	V
bé	N
tèo_teo	N
rất	R
hay	C
trèo	V
cây	N
.	CH

Tôi	P
từng	P
sống	V
ở	E
nông_thôn	N
với	E
ông_bà	N
của	E
tôi	P
.	CH

Lớp_học	N
của	E
họ	P
ngày_càng	X
thu_hút	V
nhiều	A
học_viên	N
.	CH

Hồi	N
lên	V
sáu	M
,	CH
tôi	P
đã	R
thấy	V
một	M
bức	Nc
tranh	V
tuyệt	V
đẹp	A
.	CH

Trên	E
thế_giới	N
này	P
còn	C
tồn_tại	V
rất	R
nhiều	A
điều	N
kỳ_bí	A
.	CH

Khi	N
nào	P
chúng_ta	P
sẽ	R
trưởng_thành	V
?	CH

Ôi	I
nó	P
thật	T
là	V
đẹp	A
làm_sao	X
!	CH

Ở	E
nhà	N
bạn	N
thường	R
làm	V
gì	P
vào	E
buổi	N
tối	N
?	CH

Anh	Np
nói	V
vậy	P
,	CH
chúng_nó	P
không	R
nghe	V
đâu	P
.	CH

Cuối	N
tuần	N
này	P
,	CH
Nam	Np
và	Cc
An	Np
cùng	A
tham_gia	V
giải	N
chạy_việt_dã	N
được	V
tổ_chức	V
tại	E
làng	N
đại_học	N
quốc_gia	N
thành_phố	N
Hồ_Chí_Minh	Np
.	CH

Giảm	V
6	M
tháng	N
tù	V
cho	E
cựu	X
thứ_trưởng	N
Nguyễn_Văn_Hiến	Np
.	CH

Ô_tô	Np
lao	V
vào	E
sườn	N
đồi	N
lật	V
ngửa	V
rồi	C
bốc	V
cháy	V
dữ_dội	A
,	CH
tài_xế	N
tử_vong	V
trong	E
xe	N
.	CH

Cục	Np
An_ninh	Np
điều_tra	V
nhận	V
danh_hiệu	N
Anh_hùng	N
lực_lượng_vũ_trang	N
nhân_dân	N
.	CH

Ô_nhiễm	V
không_khí	N
,	CH
bầu_trời	N
Hà_Nội	Np
mù_mờ	A
cả	P
ngày	N
.	CH

Kết_thúc	V
trận	N
đấu	V
với	E
tỉ_số	N
nghiêng	V
về	E
đội	N
bóng_chuyền	N
đến	V
từ	E
UIT	Np
.	CH

Than_ôi	Np
,	CH
sao	P
mày	P
hay	C
ra_vẻ	X
quá	R
à	T
!	CH

Chào_mừng	V
bạn	N
đã	R
đến	V
với	E
huyện	N
Tây_Hoà	Np
–	CH
nơi	N
giao_lưu	V
,	CH
kết_nối	V
yêu_thương	V
.	CH

Đại_dịch	Np
Covid-19	V
thật	T
khủng_khiếp	V
,	CH
nó	P
bao_trùm	V
sự	N
chết_chóc	V
ở	E
khắp	A
mọi	L
nơi	N
.	CH

Ông	N
Minh	Np
yêu_cầu	V
mau_chóng	A
đi	V
đến	V
thống_nhất	V
cuối_cùng	A
của	E
thoả_thuận	V
này	P
.	CH

Bỗng_dưng	Np
muốn	V
khóc	V
cho	E
lòng	N
nhẹ	A
nỗi	Nc
đau	V
.	CH

Thân	Np
em	N
vừa	R
trắng	A
lại	R
vừa	R
tròn	A
,	CH
bảy	M
nổi	V
ba	M
chìm	V
với	E
nước_non	N
.	CH

Hàng	N
trăm	M
hộ	N
dân	N
ở	E
chung_cư	N
Phú_Mỹ_Hưng	Np
có	V
đời_sống	N
rất	R
giàu_sang	A
.	CH

Tôi	P
có_thể	R
dùng	V
nước|N	N
uống|V	V
miễn_phí	V
ở	E
đây	P
phải	V
không	R
?	CH

Phải	V
đủ	A
điểm	N
thì	C
mới	A
được	V
lên_lớp	V
.	CH

Có	V
nên	C
đưa	V
người	N
nghèo	A
ra	V
thử_nghiệm	V
nhà	N
chống	V
lũ	N
?	CH

Vui_lòng	Np
không	R
hút	V
thuốc	N
tại	E
khu_vực	N
này	P
.	CH

Bà	N
Đoàn_Thiên_Ân	Nc
làm	V
bí_thư	N
Đảng_uỷ	Np
Quân_sự	N
TP.HCM	Np
.	CH

Xe	N
điên	A
húc	V
nhiều	A
xe_máy	N
dính	V
cứng_ngắc	A
vào	E
gốc	N
cây	N
ở	E
công_viên	N
Tầm_Vu	Np
.	CH

Đà_Nẵng	Np
chỉ	R
có	V
12	M
%	CH
tuyến	N
đường	N
đạt	V
chuẩn	N
cho	E
xe_buýt	N
.	CH

Những	L
cánh	N
đồng	N
mênh_mông	A
kéo	V
dài	A
bất_tận	A
mọi	L
miền	N
quê	N
của	E
Tổ_quốc	N
.	CH

Thủ_tướng	N
nhấn	V
nút	N
khởi_công	V
khu	N
công_nghiệp	N
gần	A
3.900	M
tỉ	M
tại	E
Thái_Bình	Np
.	CH

Miền	Np
Bắc	Np
đón	V
đợt	N
rét	A
đậm	A
đầu_tiên	A
năm	N
nay	P
,	CH
vùng	N
núi	N
có_thể	R
có	V
băng_giá	V
.	CH

Trường_hợp	Np
nào	P
thuộc	V
diện	N
tinh_giản	A
biên_chế	V
theo	V
quy_định	V
mới	A
?	CH

Ngắm	Np
đoàn	N
tàu	N
lần	N
đầu	N
chạy	V
thử	V
toàn	V
tuyến	N
trên	E
đường_sắt	N
Cát_Linh	Np
-	CH
Hà_Đông	Np
.	CH