Mỗi|D buổi|N sáng|N ,|CH Lan|Np thức_dậy|V sớm|A để|C đi|V học|V .|CH
Con|Nc chim|N chích_bông|N bé|A tèo_teo|A rất|R hay|R trèo|V cây|N .|CH
Tôi|P từng|R sống|V ở|E nông_thôn|N với|C ông_bà|N của|E tôi|P .|CH
Lớp_học|N của|E họ|P ngày|N càng|R thu_hút|V nhiều|A học_viên|N .|CH
Hồi|N lên|V sáu|M ,|CH tôi|P đã|R thấy|V một|M bức_tranh|N tuyệt|R đẹp|A .|CH
Trên|E thế_giới|N này|I còn|R tồn_tại|V rất|R nhiều|A điều|Nc kỳ_bí|A .|CH
Khi|N nào|I chúng_ta|P sẽ|R trưởng_thành|V ?|CH
Ôi|O nó|P thật|I là|I đẹp|A làm|V sao|I !|CH
Ở|V nhà|N bạn|N thường|R làm|V gì|P vào|E buổi|N tối|N ?|CH
Anh|N nói|V vậy|P , chúng_nó|P không|R nghe|V đâu|I .|CH
Cuối|N tuần|N này|I ,|CH Nam|Np và|CC An|Np cùng|A tham_gia|V giải|N chạy|V việt_dã|N được|R tổ_chức|V tại|E làng|N đại_học|N quốc_gia|N thành_phố|N Hồ_Chí_Minh|Np .|CH
Giảm|V 6|M tháng|N tù|N cho|V cựu|Z thứ_trưởng|N Nguyễn_Văn_Hiến|Np .|CH
Ô_tô|N lao|V vào|E sườn_đồi|N lật_ngửa|V rồi|C bốc_cháy|V dữ_dội|A ,|CH tài_xế|N tử_vong|V trong|E xe|N .|CH
Cục|Nu An_ninh|N điều_tra|V nhận|V danh_hiệu|N Anh_hùng|N lực_lượng|N vũ_trang|N nhân_dân|N .|CH
Ô_nhiễm|V không_khí|N ,|CH bầu_trời|N Hà_Nội|Np mù_mờ|A cả|P ngày|N .|CH
Kết_thúc|V trận_đấu|N với|C tỉ_số|N nghiêng|V về|E đội|Nu bóng_chuyền|N đến|V từ|E UIT|AB .|CH
Than|V ôi|O ,|CH sao|I mày|P hay|R ra_vẻ|V quá|R à|O !|CH
Chào_mừng|V bạn|N đã|R đến|V với|C huyện|N Tây_Hoà|Np –|CH nơi|N giao_lưu|V ,|CH kết_nối|V yêu_thương|V .|CH
Đại_dịch|N Covid-19|FL thật|I khủng_khiếp|A ,|CH nó|P bao_trùm|V sự|N chết_chóc|V ở|E khắp|A mọi|D nơi|N .|CH
Ông|N Minh|Np yêu_cầu|V mau_chóng|V đi|V đến|E thống_nhất|V cuối_cùng|A của|E thoả_thuận|V này|P .|CH
Bỗng_dưng|R muốn|V khóc|V cho|V lòng|N nhẹ|A nỗi_đau|N .|CH
Thân|N em|N vừa|A trắng|A lại|R vừa|A tròn|A ,|CH bảy|M nổi|V ba|M chìm|V vớiC nước_non|N .|CH
Hàng|R trăm|M hộ_dân|N ở|E chung_cư|N Phú_Mỹ_Hưng|Np có|V đời_sống|N rất|R giàu_sang|A .|CH
Tôi|P có_thể|R dùng|V nước_uống|N miễn_phí|A ở|E đây|P phải|A không|R ?|CH
Phải|V đủ|A điểm|N thì|C mới|C được|A lên|V lớp|N .|CH
Có|R nên|V đưa|V người|Nc nghèo|A ra|R thử_nghiệm|V nhà|N chống|V lũ|N ?|CH
Vui_lòng|A không|R hút|V thuốc|N tại|E khu_vực|N này|P .|CH
Bà|N Đoàn_Thiên_Ân|Np làm|V bí_thư|N Đảng_uỷ|N Quân_sự|N TP.HCM|AB .|CH
Xe|N điên|A húc|V nhiều|A xe_máy|N dính|V cứng_ngắc|A vào|E gốc_cây|N ở|E công_viên|N Tầm_Vu|Np .|CH
Đà_Nẵng|Np chỉ|R có|V 12|M %|X tuyến|N đường|N đạt|V chuẩn|A cho|E xe_buýt|N .|CH
Những|D cánh_đồng|N mênh_mông|A kéo|V dài|A bất_tận|A mọi|D miền|N quê|N của|E Tổ_quốc|N .|CH
Thủ_tướng|N nhấn|V nút|N khởi_công|V khu|N công_nghiệp|N gần|A 3.900|M tỉ|M tại|E Thái_Bình|Np .|CH
Miền_Bắc|Np đón|V đợt|N rét|A đậm|A đầu_tiên|A năm|Nu nay|P ,|CH vùng|N núi|N có_thể|R có|V băng_giá|A .|CH
Trường_hợp|N nào|P thuộc|V diện|N tinh_giản|V biên_chế|N theo|E quy_định|N mới|A ?|CH
Ngắm|V đoàn|N tàu|N lần|N đầu|N chạy|V thử|V toàn|D tuyến|N trên|E đường_sắt|N Cát_Linh|Np -|CH Hà_Đông|Np .|CH
Chính_phủ|N tiếp_tục|V xây_dựng|V một|M lớp|N nông_dân|N mới|A nắm|V chắc|A kinh_tế|N số|N .|CH
Thế_hệ|N gen_Z|FL ngày|N càng|R tiến_bộ|A trong|E việc|N tiếp_cận|V thông_tin|N liên_tục|A và|CC nhanh_chóng|A .|CH
Các|D nhà|Nc phát_triển|V công_nghệ|N không|R ngừng|V đầu_tư|V ,|CH đổi_mới|V để|C phát_triển|V xã_hội|N .|CH
Trong|E rẫy|N cà_phê|N ,|CH gom|V đến|I 180|M đạn|N pháo|N 105|M ly|Nu .|CH
Chủ|N đầu_tư|N toà_nhà|N 8B|X Lê_Trực|Np đã|R nhận|V công_trình|N sau|N cưỡng_chế|V .|CH